1111111
10E00C1
1P000E1
1000C01
1111111